SO  ./pictures/wolf_textures/mossy.png

EA      ./pictures/wolf_textures/purplestone.png
WE      ./pictures/wolf_textures/colorstone.png   
NO  ./pictures/new-us.png
F 220,100,0
C 225,30,0

111111
100101
100001
110S01
111111
