
EA      ./pictures/underwater/seaweed.png
WE      ./pictures/underwater/underwater2.png
NO  ./pictures/underwater/shark.png
SO  ./pictures/underwater/starfish.png
F 38,163,247
C 38,247,231



1111 1111111111 111111111
1001 1000000001 100000011
1011 100000111  101000001
1001 1001111111  10101111
111110000000011111010001
   100011011111   1110001
1111011110100011111000111
1111011110001111011110001
100000000100001000001111
1011111111111111111111111
101
1011111111111111111111111
1000111111  1011111111111
111000111111010000010001
1111000000000011110010001
   100011011111   1110001
1111011110100011111000111
1000000000000000000000001
1000000000001000000000001
1000000000010N00000000001
1000000000000000000000001
1000000000000000000000001
1000000000000000000000001
1000000000000000000000001
1111111111111111111111111